1111111111111111111111111111111111111111
1000010000000100010100000000001000000001
1011111000010000000000100000333333000001
1000333333331300001000100113133333000001
1000003313333333333000000000001000000001
1000000033333133133333300000000000000001
1000033333333333000100000000333330000001
1000010001000000000000010103333333330001
1000000000000000001000000000100000000001
1000001000100000000011110001001000000001
1000000001100000333333333331313000000001
1000333333333333333333313333331131330001
1000001003333313333313313333333333333001
1000010000000033333313333333333330000001
1000000000000000000033313333000000000001
1001000000000010010001000000000111000101
1000001000100000100010000100001000000001
1001003333333333133333333313333330000101
1000000003333333333333333330001000000001
1010003333333133333333330000000110001001
1000100031333333331333333333333330000001
1010001001000000010100001000100001110001
1010000010000000000000000000000000001001
1000010000010000001011003333333333333331
1001000333333333333333333300000000100001
1000000010000000000033333333001000000001
1001100000100000000000033330000000110001
1000100000011000000000100333333000001001
1000001101000000000010000333300010100001
1111111111111111111111111111111111111111