1111111111111111111111111111111111111111
1000000000033333333333333333333333300001
1000000000033333333333333333333333300001
1000000000033333333333333333333333300001
1000333000033333333333333333333333300001
1000310000033333333333333333333333300001
1000310000033331111111133333333333300001
1003313000033331111111133333333333300001
1000013000033331111111133333333333300001
1000003000033331111111133333333333300001
1000003000033331111111133333333333300001
1000000000033331111111133333333333300001
1000000000033331111111133333333333300001
1000000000033331111111133333333333300001
1000000000033331111111133333333333300001
1000000000033331111111133333333333300001
1000000000033331111111133333333333300001
1000000000033331111111133333333333300001
1000033000033331111111133333333333300001
1000330000033331111111133333333333300001
1000330000033331111111133333333333300001
1000300000033331111111133333333333300001
1000300000033331111111133333333333300001
1000300000033331111111133333333333300001
1000000000033331111111133333333333300001
1000000000033331111111133333333333300001
1000000000033331111111133333333333300001
1000000000033331111111133333333333300001
1000000000033331111111133333333333300001
1000000000033331111111133333333333300001
1000000000033331111111133333333333300001
1000000000000000000000000000000000000001
1000000000000000000000000000000000000001
1111111111111111111111111111111111111111