1111111111
1000000001
1001110001
1000011001
1000000001
1000111001
1010101001
1010101001
1222222221
1111111111