1111111111
1300000001
1001112001
1000011001
1200000031
1000111001
1000101001
1200101001
1000001001
1111111111